----------------------------------------------------------------------------------------------------
|                                                                🌊🌊🌊🌊🌊🌊🌊🌊                          |
|                                                                 🌊🌊🌊🌊🌊🌊🌊                          ★
|                                                                  🌊🌊🌊🌊🌊🌊🌊                         ★
|                                                                   🌊🌊🌊🌊🌊🌊                         ★
|                                                                    🌊🌊🌊🌊🌊🌊                        |
|                                                                     🌊🌊🌊🌊🌊🌊                       |
|                                                                      🌊🌊🌊🌊🌊🌊                      |
|                                                                       🌊🌊🌊🌊🌊🌊                    |
|           |                                                            🌊🌊🌊🌊🌊🌊                    |
|           |                                                            /🌊🌊🌊🌊🌊🌊                   |
|           |                                                           /  🌊🌊🌊🌊🌊🌊                  |
|           |                                                          /    🌊🌊🌊🌊🌊🌊                 |
|           |                _________                                       🌊🌊🌊🌊🌊🌊                |
|           |               |         |                                      /🌊🌊🌊🌊🌊🌊               |
|           |               |         |                                     /  🌊🌊🌊🌊🌊🌊              |
|           |               |         |                                         🌊🌊🌊🌊🌊🌊             |
|           |               |_________|                                          🌊🌊🌊🌊🌊🌊            |
|           |                    ⚗                                                🌊🌊🌊🌊🌊🌊🌊          |
|           |                                                                      🌊🌊🌊🌊🌊🌊🌊🌊🌊       |
|           |                                                                       🌊🌊🌊🌊🌊🌊🌊🌊🌊🌊     |
|           |                                         &                              🌊🌊🌊🌊🌊🌊🌊🌊🌊🌊🌊🌊  |
|                                      ♺         _____                               🌊🌊🌊🌊🌊🌊🌊🌊🌊🌊🌊🌊🌊
|           |     ♺                             ()   ()                                🌊🌊🌊🌊🌊🌊🌊🌊🌊🌊🌊🌊
|           |                 ♺                 ()   ()                                 🌊🌊🌊🌊🌊🌊🌊🌊🌊🌊🌊
|           |                                   ()___()                                  🌊🌊🌊🌊🌊🌊🌊🌊🌊🌊
|           |        ♺                                                                    🌊🌊🌊🌊🌊🌊🌊🌊🌊
|           |                             ♺                                                🌊🌊🌊🌊🌊🌊🌊🌊
|           |                                                                               🌊🌊🌊🌊🌊🌊🌊
----------------------------------------------------------------------------------------------------
