----------------------------------------------------------------------------------------------------
|                                                                🌊🌊🌊🌊🌊🌊🌊🌊                          |
|                                                                 🌊🌊🌊🌊🌊🌊🌊                          ☢
|                                                                  🌊🌊🌊🌊🌊🌊🌊                         |
|                                                                   🌊🌊🌊🌊🌊🌊                         |
|                                                                    🌊🌊🌊🌊🌊🌊                        |
|                                                                     🌊🌊🌊🌊🌊🌊                       |
|                                                                      🌊🌊🌊🌊🌊🌊                      |
|                                                                       🌊🌊🌊🌊🌊🌊                     |
|           |                                                            🌊🌊🌊🌊🌊🌊                    |
|           |                                                            /🌊🌊🌊🌊🌊🌊                   |
|           |                                                           /  🌊🌊🌊🌊🌊🌊                  |
|           |                                                          /    🌊🌊🌊🌊🌊🌊                 |
|           |                _________                                       🌊🌊🌊🌊🌊🌊                |
|           |               |         |                                      /🌊🌊🌊🌊🌊🌊               |
|           |               |         |                                     /  🌊🌊🌊🌊🌊🌊              |
|           |               |         |                                         🌊🌊🌊🌊🌊🌊             |
|           |               |_________|                                          🌊🌊🌊🌊🌊🌊            |
|           |                    ⚗                                                🌊🌊🌊🌊🌊🌊🌊          |
|           |                                                                      🌊🌊🌊🌊🌊🌊🌊🌊🌊       |
|           |                                                                       🌊🌊🌊🌊🌊🌊🌊🌊🌊🌊     |
|           |                                                                        🌊🌊🌊🌊🌊🌊🌊🌊🌊🌊🌊🌊  |
|           |                          ♺         _____                               🌊🌊🌊🌊🌊🌊🌊🌊🌊🌊🌊🌊🌊
|           |     ♺                             (     )                                🌊🌊🌊🌊🌊🌊🌊🌊🌊🌊🌊🌊
|           |                 ♺                 (     )                                 🌊🌊🌊🌊🌊🌊🌊🌊🌊🌊🌊
|           |                                   (_____)                                  🌊🌊🌊🌊🌊🌊🌊🌊🌊🌊
|           |        ♺                                                                    🌊🌊🌊🌊🌊🌊🌊🌊🌊
|           |                             ♺                                                🌊🌊🌊🌊🌊🌊🌊🌊
|           |                                                                               🌊🌊🌊🌊🌊🌊🌊
----------------------------------------------------------------------------------------------------
