----------------------------------------------------------------------------------------------------
|                                                                🌊🌊🌊🌊🌊🌊🌊🌊                   ⤩      |
|                                                                 🌊🌊🌊🌊🌊🌊🌊        ⤩                 ★
|                                                                  🌊🌊🌊🌊🌊🌊                          ★
|                                                                   🌊🌊🌊🌊🌊   ⤩           ⤩          ★
|                                                                    🌊🌊🌊🌊                          |
|                                                                     🌊🌊🌊           ⤩         ⤩    |
|                                                                      🌊🌊🌊  /                      |
|                                                                       🌊  /       /     ⤩         |
|           |                                                             /       /                |
|           |                                                            /       /                 |
|           |                                                           /       /        ⤩         |
|           |                                                          /       /🌊                  |
|           |                _________                                        /🌊🌊🌊🌊                |
|           |               |         |                                      /🌊🌊🌊🌊🌊🌊               |
|           |               |         |                                     /  🌊🌊🌊🌊🌊🌊              |
|           |               |         |                                         🌊🌊🌊🌊🌊🌊             |
|           |               |_________|                                          🌊🌊🌊🌊🌊🌊            |
|           |                    ⚗                                                🌊🌊🌊🌊🌊🌊🌊          |
|           |                                                                      🌊🌊🌊🌊🌊🌊🌊🌊🌊       |
|           |                                                                       🌊🌊🌊🌊🌊🌊🌊🌊🌊🌊     |
|           |                                         &                              🌊🌊🌊🌊🌊🌊🌊🌊🌊🌊🌊🌊  |
|           |                                    _____                               🌊🌊🌊🌊🌊🌊🌊🌊🌊🌊🌊🌊🌊
|           |                                   ()   ()                                🌊🌊🌊🌊🌊🌊🌊🌊🌊🌊🌊🌊
|           |                                   ()   ()                                 🌊🌊🌊🌊🌊🌊🌊🌊🌊🌊🌊
|           |                                   ()___()                                  🌊🌊🌊🌊🌊🌊🌊🌊🌊🌊
|           |                                                                             🌊🌊🌊🌊🌊🌊🌊🌊🌊
|           |                                                                              🌊🌊🌊🌊🌊🌊🌊🌊
|           |                                                                               🌊🌊🌊🌊🌊🌊🌊
----------------------------------------------------------------------------------------------------
