------------------------------------------------★★★★-----------------------------------------------
|    |__                                       |     |                                      __|    |
|       |__                                    |     |                                   __|       |
|          |__                                 |     |                                __|          |
|             |__                              |     |                             __|             |
|                |__                           |     |                          __|         ____   |
|                   |__                        |     |                       __|           ()  ()  |
|                      |__                     |     |                   __|               ()  ()  |
|                         |__                  |     |                 __|                 ()__()  |
|                            |_________________|     |________________|                            |
|                                               ⯂x⯂x⯂x⯂x⯂ 			                                 |
|                                                                                                  |
|   ____                                                                                           |
|  |    |                                                                                          |
|  |    |                                                                     _____   ♞      ♞     |
|  |____|     ____                                                           /     \               |
|            |    |                                                        ⚗|   ♞  |     ♞         |
|            |    |                                                          \_____/ ♞             |
|            |____|                                                            ♞              ♞    |
|    ⤩      ____        ⤩                                                                        ♞ |
|  ____    |    |   ____                                                                           |
| |    |   |    |  |    |       ___                                              ♞        ♞        |
| |    |   |____|  |    |      |   |                                                               |
| |____|           |____|      |___|                                                               |
|                                                                                                  |
|    ⤩                                                                                             |
|       ____     ____                                                                              |
|      |    |   |    |   ⤩                                                                         |
|      |____|   |____|                                                                             |
----------------------------------------------------------------------------------------------------
